15
2 2 2 2 0.2 2 2 2 2 2 2 2 2 2 0.4 
2 2 2 2 2 2 1 2 2 2 2 2 2 2 0 
2 2 2 0.2 2 0.9 0.3 0.1 2 2 2 2 2 2 2 
2 2 0.4 2 2 2 2 0.7 2 2 2 2 2 2 2 
0.8 2 2 2 2 2 2 2 2 2 2 2 2 2 0 
2 2 0.4 2 2 2 2 2 0.2 0.2 0.2 2 2 2 0.7 
2 1 0.3 2 2 2 2 2 2 2 0.2 2 0 2 2 
2 2 0.5 0 2 2 2 2 2 2 2 2 0.9 2 2 
2 2 2 2 2 0.2 2 2 2 0.7 2 2 2 2 0.6 
2 2 2 2 2 2 2 2 0.4 2 0.4 2 2 2 2 
2 2 2 2 2 0.6 0.4 2 2 0.4 2 0.2 0.9 2 2 
2 2 2 2 2 2 2 2 2 2 0.8 2 0.1 2 2 
2 2 2 2 2 2 0.1 0.6 2 2 1 0.3 2 0.9 2 
2 2 2 2 2 2 2 2 2 2 2 2 1 2 2 
0.2 0.1 2 2 0.2 0.4 2 2 0.5 2 2 2 2 2 2 
1000 1000 1000 1000 12 1000 1000 1000 1000 1000 1000 1000 1000 1000 8 
1000 1000 1000 1000 1000 1000 1000 1000 1000 1000 1000 1000 1000 1000 7 
1000 1000 1000 9 1000 24 17 11 1000 1000 1000 1000 1000 1000 1000 
1000 1000 4 1000 1000 1000 1000 7 1000 1000 1000 1000 1000 1000 1000 
6 1000 1000 1000 1000 1000 1000 1000 1000 1000 1000 1000 1000 1000 3 
1000 1000 13 1000 1000 1000 1000 1000 8 9 7 1000 1000 1000 6 
1000 1000 7 1000 1000 1000 1000 1000 1000 1000 3 1000 4 1000 1000 
1000 1000 8 11 1000 1000 1000 1000 1000 1000 1000 1000 1000 1000 1000 
1000 1000 1000 1000 1000 4 1000 1000 1000 13 1000 1000 1000 1000 10 
1000 1000 1000 1000 1000 1000 1000 1000 7 1000 6 1000 1000 1000 1000 
1000 1000 1000 1000 1000 4 5 1000 1000 12 1000 13 9 1000 1000 
1000 1000 1000 1000 1000 1000 1000 1000 1000 1000 5 1000 8 1000 1000 
1000 1000 1000 1000 1000 1000 4 2 1000 1000 1000 4 1000 1000 1000 
1000 1000 1000 1000 1000 1000 1000 1000 1000 1000 1000 1000 1000 1000 1000 
12 4 1000 1000 8 5 1000 1000 3 1000 1000 1000 1000 1000 1000 
7 12